111111111111
10C0010101C1
101001011001
1C000CCCC001
101501001001
111111011111
111111001111
10C001010101
101000P11001
1C0E0C0CC001
101001001001
111111100111
10C001010101
101001010001
1C000CC00001
101001001001
111111111111