111111111111
10C001010101
101001011001
1C000CCCC001
101001001001
111111011111
111111001111
10C001010101
101001P11001
1C0E0CCCC001
101001001001
111111100111
10C001010101
101001010001
1C000CC0CC01
101001001001
111111111111