111111111111111111111111
10C001C1010000C001010101
101001011000001001011001
1C000CCCC0000C000CCCC001
101001001000001001001001
10000001111001111C000001
111000010000011110001111
10C00101010000C001010101
101000011000001000P11001
1C000C0CC0000C000C0CC001
101001001000001001001001
111111100110011111100111
10C00101010000C001010101
101001010000001001010001
1C000CC000000C000CC00001
1E1001001000001001001001
111111111111111111111111