111111111111
10C0010C0101
101001P01001
1C000CCCC001
101001001001
1C000CCCC001
111111111111