111111111111
10C0010C0001
100001P00001
10000CCCC001
111111111111