111111111111111111111111
10CX01C1010000C001010101
101001011000001001011001
1C000CCCC0000C000CCCC001
101001001000001001001001
100101001111001111C00001
11100X010X00011110X01111
10C00101010000C001010101
101000011000X01000P11001
1C0X0C0CC00X0C000C0CC001
101001001000001001001001
11111110011X011111100111
10C0010101X000C001010101
101001010000001001010001
1C0X0CC000X00C000CC00X01
1E1001001000001001001001
10000X0000010000000X0001
111111111111111111111111
