1111111111111111111111111
10CX01C1010000C0010101011
1010010110000010010110011
1C000CCCC0000C000CCCC0011
1010010010000010010010011
100101001111001111C000011
11100X010X00011110X011111
10C00101010000C0010101011
101000011000X01000P110011
1C0X0C0CC00X0C000C0CC0011
1010010010000010010010011
11111110011X0111111001111
10C0010101X000C0010101011
1010010100000010010100011
1C0X0CC000X00C000CC00X011
1E10010010000010010010011
100X001110000000000X00011
1111111111111111111111111