1111111111111111111111111
1C0001C1010000C0010101011
1110010110000010010110011
1C000CCCC0000C000CCCC0011
1010010010000010010010011
100101001111001111C000011
1110000100000111100011111
10C00101010000C0011101011
101000011000001001P110011
1C000C0CC0000C000C0CC0011
1010010010000010010010011
1111111001100111111001111
10C00101010000C0010101011
1010010100000010010100011
1C000CC000000C000CC000011
1010010010000010010010011
1000001010000000000000011
100E000000010000000000011
1111111111111111111111111
